# --------------------------------- #
#       WEBSITES FOR SOURCE.C       #
# --------------------------------- #





# ----------------------------------------- #
#       WEBSITES FOR THE EXPLOITATION       #
# ----------------------------------------- #